

  p
           +-----------..-----------+
           |........................|
           |........................|
           .........................|
           .........................|
           |........................|
           |........................|
           |........................|
           +------------------------+










































