
                  s            s

           +-------------|----------+
       X   |.............|.........p|
           |.....l.......|.........p|
           |.............|.........p|
          sd.............d......l.cp| s
           |.............|.........p|
           |.......l.....|.........p|
           |.............|.........p|
           +-------------|----------+
                  s            s





















































