

  p
           +-----------..-----------+
           |........................|
           |........................|
           .........................|
           .....................l...|
           |........................|
           |........................|
           |........................|
           +------------------------+


               l







































