
                  s            s

           +-------------|----------+
           |.............|....X....p|
           |.....l.......|.........p|
    C      |.............|.........p|
          sd.............d......l.cp| s
           |.............|.........p|
           |.......l.....|.........p|
           |.............|.........p|
           +-------------|----------+
                  s            s





















































