

  p
           +-----------..-----------+
           |........................|
           |.....l..................|
           .........................|
           .....................l...|
           |........................|
           |.......l................|
           |........................|
           +------------------------+






















































